AAAACTCGGTC -> AAACTCGGTCG
AAACCATCGTG -> AACCATCGTGT
AAACCCGAGGT -> AACCCGAGGTT
AAACTAACGGG -> AACTAACGGGG
AAACTCGGTCG -> AACTCGGTCGG
AAACTGCCACG -> AACTGCCACGC
AAACTTTACAC -> AACTTTACACA
AAAGAGGGTTA -> AAGAGGGTTAT
AAAGTGAATTC -> AAGTGAATTCC
AAATATGAGTT -> AATATGAGTTC
AACAACGAATG -> ACAACGAATGT
AACCATCGTGT -> ACCATCGTGTC
AACCCGAGGTT -> ACCCGAGGTTC
AACCCGTAACA -> ACCCGTAACAA
AACGAACTGTT -> ACGAACTGTTC
AACGAATGTCA -> ACGAATGTCAG
AACGGGGTAGG -> ACGGGGTAGGT
AACGTGTAACC -> ACGTGTAACCC
AACTAACGGGG -> ACTAACGGGGT
AACTCGGTCGG -> ACTCGGTCGGA
AACTCGTCCAT -> ACTCGTCCATC
AACTGCCACGC -> ACTGCCACGCA
AACTGTTCAGG -> ACTGTTCAGGA
AACTTTACACA -> ACTTTACACAT
AAGAAACTTTA -> AGAAACTTTAC
AAGAGGAGGTG -> AGAGGAGGTGA
AAGAGGGTTAT -> AGAGGGTTATC
AAGATTGCCGT -> AGATTGCCGTC
AAGCAATTTCT -> AGCAATTTCTT
AAGCACATATC -> AGCACATATCG
AAGCCGGTCTT -> AGCCGGTCTTT
AAGCGGGGCAG -> AGCGGGGCAGA
AAGCTTAAGCC -> AGCTTAAGCCG
AAGGTCACGCA -> AGGTCACGCAA
AAGGTGAATAG -> AGGTGAATAGT
AAGTAGCCCGG -> AGTAGCCCGGC
AAGTAGGGCTT -> AGTAGGGCTTC
AAGTCACTACG -> AGTCACTACGA
AAGTGAATTCC -> AGTGAATTCCC
AAGTGATCAGG -> AGTGATCAGGC
AAGTGTGAGAC -> AGTGTGAGACT
AATAAACCCGA -> ATAAACCCGAG
AATAACTCGTC -> ATAACTCGTCC
AATACAAGGTC -> ATACAAGGTCA
AATAGTGTTCC -> ATAGTGTTCCT
AATATGAGTTC -> ATATGAGTTCG
AATCAAGGTGA -> ATCAAGGTGAA
AATGACATATT -> ATGACATATTG
AATGATAGTCA -> ATGATAGTCAG
AATGTCAGACA -> ATGTCAGACAT
AATTCCAGGGC -> ATTCCAGGGCG
AATTCCCCCTG -> ATTCCCCCTGC
AATTTCTTCAC -> ATTTCTTCACT
ACAACGAATGT -> CAACGAATGTC
ACAACGTGTAA -> CAACGTGTAAC
ACAAGGTCACG -> CAAGGTCACGC
ACACATGAGTT -> CACATGAGTTT
ACACTGCGACA -> CACTGCGACAG
ACAGCGTGATC -> CAGCGTGATCA
ACAGCTGTAGT -> CAGCTGTAGTA
ACAGTTATCCC -> CAGTTATCCCC
ACAGTTGCTGA -> CAGTTGCTGAG
ACATATCGATC -> CATATCGATCG
ACATATTGACC -> CATATTGACCG
ACATCCCCTGC -> CATCCCCTGCC
ACATGAGTTTT -> CATGAGTTTTT
ACATGTATATA -> CATGTATATAA
ACATTAGGGTC -> CATTAGGGTCG
ACCATCACACT -> CCATCACACTG
ACCATCGTGTC -> CCATCGTGTCA
ACCCAGTATAT -> CCCAGTATATC
ACCCGAGGTTC -> CCCGAGGTTCG
ACCCGCCAGCT -> CCCGCCAGCTC
ACCCGTAACAA -> CCCGTAACAAC
ACCGCATCATC -> CCGCATCATCC
ACCGCGCAAAT -> CCGCGCAAATA
ACCGGTAGAAG -> CCGGTAGAAGT
ACCGGTCATAG -> CCGGTCATAGT
ACCGTCACCTC -> CCGTCACCTCG
ACCTAAGAGGA -> CCTAAGAGGAG
ACCTCGAGTTC -> CCTCGAGTTCG
ACGAACTGTTC -> CGAACTGTTCA
ACGAAGCGGGG -> CGAAGCGGGGC
ACGAATGTCAG -> CGAATGTCAGA
ACGACTAAGTA -> CGACTAAGTAG
ACGCAAACTAA -> CGCAAACTAAC
ACGCACAGTTA -> CGCACAGTTAT
ACGCAGTTTCC -> CGCAGTTTCCT
ACGCCGTTGGT -> CGCCGTTGGTT
ACGCGAAAACT -> CGCGAAAACTC
ACGCGATTCAC -> CGCGATTCACT
ACGCGGCCCTT -> CGCGGCCCTTA
ACGGCGGTCTG -> CGGCGGTCTGT
ACGGGGTAGGT -> CGGGGTAGGTA
ACGTCTGCACG -> CGTCTGCACGG
ACGTGATCATT -> CGTGATCATTA
ACGTGTAACCC -> CGTGTAACCCG
ACTAACGGGGT -> CTAACGGGGTA
ACTAAGTAGGG -> CTAAGTAGGGC
ACTACGAAGCG -> CTACGAAGCGG
ACTATAACGAA -> CTATAACGAAC
ACTCGGTCGGA -> CTCGGTCGGAC
ACTCGTCCATC -> CTCGTCCATCC
ACTCTCCCTGA -> CTCTCCCTGAG
ACTCTTCTTGA -> CTCTTCTTGAT
ACTCTTGCTTC -> CTCTTGCTTCT
ACTGAAGTCAC -> CTGAAGTCACT
ACTGAAGTGAT -> CTGAAGTGATC
ACTGACTGAAG -> CTGACTGAAGT
ACTGCCACGCA -> CTGCCACGCAG
ACTGCGACAGC -> CTGCGACAGCT
ACTGGAGTTCG -> CTGGAGTTCGT
ACTGTTCAGGA -> CTGTTCAGGAG
ACTTTACACAT -> CTTTACACATG
AGAAACTTTAC -> GAAACTTTACA
AGAAAGAGGGT -> GAAAGAGGGTT
AGAAGCTTAAG -> GAAGCTTAAGC
AGAAGTGTGAG -> GAAGTGTGAGA
AGAATGATAGT -> GAATGATAGTC
AGACATTAGGG -> GACATTAGGGT
AGACCCAGTAT -> GACCCAGTATA
AGACGCGATTC -> GACGCGATTCA
AGACTCTTCTT -> GACTCTTCTTG
AGACTGGAGTT -> GACTGGAGTTC
AGAGCGGACGT -> GAGCGGACGTG
AGAGGAGGTGA -> GAGGAGGTGAG
AGAGGGCATCG -> GAGGGCATCGG
AGAGGGTTATC -> GAGGGTTATCA
AGAGTAGAGGG -> GAGTAGAGGGC
AGAGTTCGTTC -> GAGTTCGTTCA
AGATATTAGCG -> GATATTAGCGT
AGATTGCCGTC -> GATTGCCGTCC
AGCAATTTCTT -> GCAATTTCTTC
AGCACATATCG -> GCACATATCGA
AGCACTGACTG -> GCACTGACTGA
AGCAGAGTAGA -> GCAGAGTAGAG
AGCATTCGTCA -> GCATTCGTCAA
AGCCCGGCAGT -> GCCCGGCAGTA
AGCCGACAACG -> GCCGACAACGT
AGCCGGTCTTT -> GCCGGTCTTTC
AGCCGTGTTGG -> GCCGTGTTGGA
AGCGGACGTGA -> GCGGACGTGAT
AGCGGCTCATG -> GCGGCTCATGT
AGCGGGGCAGA -> GCGGGGCAGAC
AGCGTACGCAC -> GCGTACGCACA
AGCGTGATCAG -> GCGTGATCAGT
AGCGTGTCACC -> GCGTGTCACCG
AGCTCGATCTT -> GCTCGATCTTA
AGCTGTAGTAC -> GCTGTAGTACG
AGCTTAAGCCG -> GCTTAAGCCGG
AGGAGGTGAGC -> GGAGGTGAGCA
AGGAGTGTCCG -> GGAGTGTCCGA
AGGCAAACTGC -> GGCAAACTGCC
AGGCAGAGTTC -> GGCAGAGTTCG
AGGCTCACAGC -> GGCTCACAGCG
AGGGCATCGGC -> GGGCATCGGCG
AGGGCGGTCAT -> GGGCGGTCATT
AGGGCTTCCGG -> GGGCTTCCGGG
AGGGTCGCGCA -> GGGTCGCGCAG
AGGGTCTTACG -> GGGTCTTACGC
AGGGTTATCAG -> GGGTTATCAGG
AGGTAGATATT -> GGTAGATATTA
AGGTCACGCAA -> GGTCACGCAAA
AGGTGAATAGT -> GGTGAATAGTG
AGGTGAGCATT -> GGTGAGCATTC
AGGTGCACCGG -> GGTGCACCGGT
AGGTTCGAGAC -> GGTTCGAGACT
AGTAAGTAGCC -> GTAAGTAGCCC
AGTACCGCATC -> GTACCGCATCA
AGTACGACTAA -> GTACGACTAAG
AGTACGCGGCC -> GTACGCGGCCC
AGTAGAGGGCA -> GTAGAGGGCAT
AGTAGCCCGGC -> GTAGCCCGGCA
AGTAGGGCTTC -> GTAGGGCTTCC
AGTATATCGTT -> GTATATCGTTA
AGTCACTACGA -> GTCACTACGAA
AGTCAGCCGAC -> GTCAGCCGACA
AGTCAGGGTCT -> GTCAGGGTCTT
AGTCGAGACGC -> GTCGAGACGCG
AGTGAATTCCC -> GTGAATTCCCC
AGTGATCAGGC -> GTGATCAGGCA
AGTGGCGTCCC -> GTGGCGTCCCA
AGTGTCCGATA -> GTGTCCGATAG
AGTGTGAGACT -> GTGTGAGACTG
AGTGTTCCTAC -> GTGTTCCTACC
AGTTATCCCCA -> GTTATCCCCAA
AGTTCGTTCAA -> GTTCGTTCAAT
AGTTCGTTCCA -> GTTCGTTCCAG
AGTTCGTTCGC -> GTTCGTTCGCC
AGTTCGTTCTC -> GTTCGTTCTCG
AGTTGCTGAGA -> GTTGCTGAGAA
AGTTGTTTCGT -> GTTGTTTCGTC
AGTTTCCTAAT -> GTTTCCTAATC
AGTTTTTCTGG -> GTTTTTCTGGT
ATAAACCCGAG -> TAAACCCGAGG
ATAAAGTGAAT -> TAAAGTGAATT
ATAACGAACTG -> TAACGAACTGT
ATAACTCGTCC -> TAACTCGTCCA
ATACAAGGTCA -> TACAAGGTCAC
ATACCATCACA -> TACCATCACAC
ATAGAAGCTTA -> TAGAAGCTTAA
ATAGGCTCACA -> TAGGCTCACAG
ATAGTAAGTAG -> TAGTAAGTAGC
ATAGTCAGCCG -> TAGTCAGCCGA
ATAGTGGCGTC -> TAGTGGCGTCC
ATAGTGTTCCT -> TAGTGTTCCTA
ATATAAAGTGA -> TATAAAGTGAA
ATATCGATCGT -> TATCGATCGTA
ATATCGTTAAG -> TATCGTTAAGA
ATATGAGTTCG -> TATGAGTTCGT
ATATGGTGCTA -> TATGGTGCTAT
ATATTAGCGTG -> TATTAGCGTGT
ATATTGACCGT -> TATTGACCGTC
ATCAAGGTGAA -> TCAAGGTGAAT
ATCACACTGCG -> TCACACTGCGA
ATCAGGCAAAC -> TCAGGCAAACT
ATCAGGCAGAG -> TCAGGCAGAGT
ATCAGTCGAGA -> TCAGTCGAGAC
ATCATCCCCTG -> TCATCCCCTGC
ATCATTATGTC -> TCATTATGTCG
ATCCCCAAGCA -> TCCCCAAGCAC
ATCCCCTGCCG -> TCCCCTGCCGA
ATCCCCTGCCT -> TCCCCTGCCTG,TCCCCTGCCTT,TCCCCTGCCTT
ATCGATCGTAA -> TCGATCGTAAT
ATCGGCGGGAA -> TCGGCGGGAAT
ATCGTAATTCC -> TCGTAATTCCA
ATCGTGTCACT -> TCGTGTCACTA
ATCGTTAAGAA -> TCGTTAAGAAA
ATCTCGAGCAC -> TCTCGAGCACT
ATCTTACAGTT -> TCTTACAGTTG
ATCTTATATGG -> TCTTATATGGT
ATGACATATTG -> TGACATATTGA
ATGAGTTCGTT -> TGAGTTCGTTC
ATGAGTTTTTC -> TGAGTTTTTCT
ATGATAGTCAG -> TGATAGTCAGC
ATGATGCGGGT -> TGATGCGGGTA
ATGCATCCCCT -> TGCATCCCCTG
ATGCGGGTAGC -> TGCGGGTAGCG
ATGGTGCTATC -> TGGTGCTATCT
ATGTATATAAA -> TGTATATAAAG
ATGTATTTGGC -> TGTATTTGGCG
ATGTCAGACAT -> TGTCAGACATT
ATGTCGACGCC -> TGTCGACGCCG
ATTAGCGTGTC -> TTAGCGTGTCA
ATTAGGGTCGC -> TTAGGGTCGCG
ATTAGTTGTTT -> TTAGTTGTTTC
ATTATGTCGAC -> TTATGTCGACG
ATTCACTGAAG -> TTCACTGAAGT
ATTCCAGGGCG -> TTCCAGGGCGG
ATTCCCCCTGC -> TTCCCCCTGCA
ATTCGTCAAGC -> TTCGTCAAGCA
ATTCTTGGTGG -> TTCTTGGTGGC
ATTGACCGTCA -> TTGACCGTCAC
ATTGCCGTCCA -> TTGCCGTCCAC
ATTGGCGATTA -> TTGGCGATTAG
ATTTCTTCACT -> TTTCTTCACTC
ATTTGGCGCTC -> TTTGGCGCTCG
CAAACTAACGG -> AAACTAACGGG
CAAACTGCCAC -> AAACTGCCACG
CAAATATGAGT -> AAATATGAGTT
CAACGAATGTC -> AACGAATGTCA
CAACGTGTAAC -> AACGTGTAACC
CAAGATTGCCG -> AAGATTGCCGT
CAAGCAATTTC -> AAGCAATTTCT
CAAGCACATAT -> AAGCACATATC
CAAGGTCACGC -> AAGGTCACGCA
CAAGGTGAATA -> AAGGTGAATAG
CAATAACTCGT -> AATAACTCGTC
CAATACAAGGT -> AATACAAGGTC
CAATGACATAT -> AATGACATATT
CAATTTCTTCA -> AATTTCTTCAC
CACACTGCGAC -> ACACTGCGACA
CACAGCGTGAT -> ACAGCGTGATC
CACAGTTATCC -> ACAGTTATCCC
CACATATCGAT -> ACATATCGATC
CACATGAGTTT -> ACATGAGTTTT
CACCGCGCAAA -> ACCGCGCAAAT
CACCGGTCATA -> ACCGGTCATAG
CACCTAAGAGG -> ACCTAAGAGGA
CACCTCGAGTT -> ACCTCGAGTTC
CACGCAAACTA -> ACGCAAACTAA
CACGGCGGTCT -> ACGGCGGTCTG
CACTACGAAGC -> ACTACGAAGCG
CACTATAACGA -> ACTATAACGAA
CACTCTCCCTG -> ACTCTCCCTGA
CACTCTTGCTT -> ACTCTTGCTTC
CACTGAAGTCA -> ACTGAAGTCAC
CACTGACTGAA -> ACTGACTGAAG
CACTGCGACAG -> ACTGCGACAGC
CAGACATTAGG -> AGACATTAGGG
CAGACCCAGTA -> AGACCCAGTAT
CAGAGTAGAGG -> AGAGTAGAGGG
CAGAGTTCGTT -> AGAGTTCGTTC
CAGCAGAGTAG -> AGCAGAGTAGA
CAGCCGACAAC -> AGCCGACAACG
CAGCGGCTCAT -> AGCGGCTCATG
CAGCGTGATCA -> AGCGTGATCAG
CAGCTCGATCT -> AGCTCGATCTT
CAGCTGTAGTA -> AGCTGTAGTAC
CAGGAGTGTCC -> AGGAGTGTCCG
CAGGCAAACTG -> AGGCAAACTGC
CAGGCAGAGTT -> AGGCAGAGTTC
CAGGGCGGTCA -> AGGGCGGTCAT
CAGGGTCTTAC -> AGGGTCTTACG
CAGTACCGCAT -> AGTACCGCATC
CAGTACGCGGC -> AGTACGCGGCC
CAGTATATCGT -> AGTATATCGTT
CAGTCGAGACG -> AGTCGAGACGC
CAGTTATCCCC -> AGTTATCCCCA
CAGTTGCTGAG -> AGTTGCTGAGA
CAGTTTCCTAA -> AGTTTCCTAAT
CATAGTAAGTA -> ATAGTAAGTAG
CATATCGATCG -> ATATCGATCGT
CATATTGACCG -> ATATTGACCGT
CATCACACTGC -> ATCACACTGCG
CATCATCCCCT -> ATCATCCCCTG
CATCCCCTGCC -> ATCCCCTGCCG,ATCCCCTGCCT,ATCCCCTGCCT,ATCCCCTGCCT
CATCGGCGGGA -> ATCGGCGGGAA
CATCGTGTCAC -> ATCGTGTCACT
CATGAGTTTTT -> ATGAGTTTTTC
CATGTATATAA -> ATGTATATAAA
CATGTATTTGG -> ATGTATTTGGC
CATTAGGGTCG -> ATTAGGGTCGC
CATTATGTCGA -> ATTATGTCGAC
CATTCGTCAAG -> ATTCGTCAAGC
CATTCTTGGTG -> ATTCTTGGTGG
CATTGGCGATT -> ATTGGCGATTA
CCAAGCACATA -> CAAGCACATAT
CCAATACAAGG -> CAATACAAGGT
CCACCTAAGAG -> CACCTAAGAGG
CCAGCTCGATC -> CAGCTCGATCT
CCAGGGCGGTC -> CAGGGCGGTCA
CCAGTACCGCA -> CAGTACCGCAT
CCAGTATATCG -> CAGTATATCGT
CCATCACACTG -> CATCACACTGC
CCATCCCCTGC -> CATCCCCTGCC
CCATCGTGTCA -> CATCGTGTCAC
CCCAAGCACAT -> CCAAGCACATA
CCCAATACAAG -> CCAATACAAGG
CCCAGTATATC -> CCAGTATATCG
CCCCAAGCACA -> CCCAAGCACAT
CCCCCTGCATT -> CCCCTGCATTG
CCCCTGCATTG -> CCCTGCATTGG
CCCCTGCCGAC -> CCCTGCCGACG
CCCCTGCCTGA -> CCCTGCCTGAT
CCCCTGCCTTC -> CCCTGCCTTCG,CCCTGCCTTCG
CCCGAGGTTCG -> CCGAGGTTCGA
CCCGCCAGCTC -> CCGCCAGCTCG
CCCGGCAGTAC -> CCGGCAGTACG
CCCGTAACAAC -> CCGTAACAACG
CCCTGAGAGCG -> CCTGAGAGCGG
CCCTGCATTGG -> CCTGCATTGGC
CCCTGCCGACG -> CCTGCCGACGT
CCCTGCCTGAT -> CCTGCCTGATA
CCCTGCCTTCG -> CCTGCCTTCGG,CCTGCCTTCGT
CCCTTATACCA -> CCTTATACCAT
CCGACAACGTG -> CGACAACGTGT
CCGACGTCTGC -> CGACGTCTGCA
CCGAGGTTCGA -> CGAGGTTCGAG
CCGATAGGCTC -> CGATAGGCTCA
CCGCATCATCC -> CGCATCATCCC
CCGCCAGCTCG -> CGCCAGCTCGA
CCGCGCAAATA -> CGCGCAAATAT
CCGGCAGTACG -> CGGCAGTACGC
CCGGCTGACAT -> CGGCTGACATC
CCGGGGATGAT -> CGGGGATGATG
CCGGTAGAAGT -> CGGTAGAAGTG
CCGGTCATAGT -> CGGTCATAGTA
CCGGTCTTTCA -> CGGTCTTTCAG
CCGTAACAACG -> CGTAACAACGA
CCGTCACCTCG -> CGTCACCTCGA
CCGTCCACCTA -> CGTCCACCTAA
CCGTCCTATGC -> CGTCCTATGCA
CCGTCTGCACT -> CGTCTGCACTC
CCGTGTTGGAC -> CGTGTTGGACA
CCGTTGGTTTG -> CGTTGGTTTGC
CCTAAGAGGAG -> CTAAGAGGAGG
CCTAATCAAGG -> CTAATCAAGGT
CCTACCGGTAG -> CTACCGGTAGA
CCTATGCATCC -> CTATGCATCCC
CCTCGAGGTGC -> CTCGAGGTGCA
CCTCGAGTTCG -> CTCGAGTTCGT
CCTGAGAGCGG -> CTGAGAGCGGA
CCTGATAGAAG -> CTGATAGAAGC
CCTGCATTGGC -> CTGCATTGGCG
CCTGCCGACGT -> CTGCCGACGTC
CCTGCCTGATA -> CTGCCTGATAG
CCTGCCTTCGG -> CTGCCTTCGGG
CCTGCCTTCGT -> CTGCCTTCGTT
CCTTATACCAT -> CTTATACCATC
CCTTCGGGGGT -> CTTCGGGGGTC
CCTTCGTTAGT -> CTTCGTTAGTC
CGAAAACTCGG -> GAAAACTCGGT
CGAACTGTTCA -> GAACTGTTCAG
CGAAGCGGGGC -> GAAGCGGGGCA
CGAATGTCAGA -> GAATGTCAGAC
CGACAACGTGT -> GACAACGTGTA
CGACAGCTGTA -> GACAGCTGTAG
CGACGCCGTTG -> GACGCCGTTGG
CGACGTCTGCA -> GACGTCTGCAC
CGACTAAGTAG -> GACTAAGTAGG
CGAGACGCGAT -> GAGACGCGATT
CGAGACTCTTC -> GAGACTCTTCT
CGAGCACTGAC -> GAGCACTGACT
CGAGGTGCACC -> GAGGTGCACCG
CGAGGTTCGAG -> GAGGTTCGAGA
CGAGTTCGTTC -> GAGTTCGTTCC
CGATAGGCTCA -> GATAGGCTCAC
CGATCGTAATT -> GATCGTAATTC
CGATCTTATAT -> GATCTTATATG
CGATTAGTTGT -> GATTAGTTGTT
CGATTCACTGA -> GATTCACTGAA
CGCAAACTAAC -> GCAAACTAACG
CGCAAATATGA -> GCAAATATGAG
CGCACAGTTAT -> GCACAGTTATC
CGCAGCGGCTC -> GCAGCGGCTCA
CGCAGTTTCCT -> GCAGTTTCCTA
CGCATCATCCC -> GCATCATCCCC
CGCCAGCTCGA -> GCCAGCTCGAT
CGCCGGCTGAC -> GCCGGCTGACA
CGCCGTCCTAT -> GCCGTCCTATG
CGCCGTTGGTT -> GCCGTTGGTTT
CGCCTCGAGGT -> GCCTCGAGGTG
CGCGAAAACTC -> GCGAAAACTCG
CGCGATTCACT -> GCGATTCACTG
CGCGCAAATAT -> GCGCAAATATG
CGCGCAGCGGC -> GCGCAGCGGCT
CGCGGCCCTTA -> GCGGCCCTTAT
CGCTCGCCTCG -> GCTCGCCTCGA
CGGACGCAGTT -> GGACGCAGTTT
CGGACGTGATC -> GGACGTGATCA
CGGCAGTACGC -> GGCAGTACGCG
CGGCCCTTATA -> GGCCCTTATAC
CGGCGGGAATA -> GGCGGGAATAA
CGGCGGTCTGT -> GGCGGTCTGTA
CGGCTCATGTA -> GGCTCATGTAT
CGGCTGACATC -> GGCTGACATCC
CGGGAATAAAC -> GGGAATAAACC
CGGGGATGATG -> GGGGATGATGC
CGGGGCAGACC -> GGGGCAGACCC
CGGGGGTCTCA -> GGGGGTCTCAA
CGGGGTAGGTA -> GGGGTAGGTAG
CGGGTAGCGTA -> GGGTAGCGTAC
CGGGTTACCCG -> GGGTTACCCGC
CGGTAGAAGTG -> GGTAGAAGTGT
CGGTCATAGTA -> GGTCATAGTAA
CGGTCATTCTT -> GGTCATTCTTG
CGGTCGGACGC -> GGTCGGACGCA
CGGTCTGTAGA -> GGTCTGTAGAA
CGGTCTTTCAG -> GGTCTTTCAGC
CGTAACAACGA -> GTAACAACGAA
CGTAATTCCAG -> GTAATTCCAGG
CGTACGCACAG -> GTACGCACAGT
CGTCAAGCAAT -> GTCAAGCAATT
CGTCAATGACA -> GTCAATGACAT
CGTCACCTCGA -> GTCACCTCGAG
CGTCCACCTAA -> GTCCACCTAAG
CGTCCATCCCC -> GTCCATCCCCT
CGTCCCAATAC -> GTCCCAATACA
CGTCCTATGCA -> GTCCTATGCAT
CGTCTGCACGG -> GTCTGCACGGC
CGTCTGCACTC -> GTCTGCACTCT
CGTGATCAGTC -> GTGATCAGTCG
CGTGATCATTA -> GTGATCATTAT
CGTGTAACCCG -> GTGTAACCCGT
CGTGTCACCGC -> GTGTCACCGCG
CGTGTCACTAT -> GTGTCACTATA
CGTGTTGGACA -> GTGTTGGACAT
CGTTAAGAAAC -> GTTAAGAAACT
CGTTAGTCAGG -> GTTAGTCAGGG
CGTTCAATAAC -> GTTCAATAACT
CGTTCCAGTAC -> GTTCCAGTACC
CGTTCGCCGTC -> GTTCGCCGTCC
CGTTCTCGCCG -> GTTCTCGCCGG
CGTTGGTTTGC -> GTTGGTTTGCG
CTAACGGGGTA -> TAACGGGGTAG
CTAAGAGGAGG -> TAAGAGGAGGT
CTAAGTAGGGC -> TAAGTAGGGCT
CTAATCAAGGT -> TAATCAAGGTG
CTACCGGTAGA -> TACCGGTAGAA
CTACGAAGCGG -> TACGAAGCGGG
CTATAACGAAC -> TATAACGAACT
CTATCTTACAG -> TATCTTACAGT
CTATGCATCCC -> TATGCATCCCC
CTCAAGATTGC -> TCAAGATTGCC
CTCACAGCGTG -> TCACAGCGTGA
CTCATGTATTT -> TCATGTATTTG
CTCCCTGAGAG -> TCCCTGAGAGC
CTCGAGCACTG -> TCGAGCACTGA
CTCGAGGTGCA -> TCGAGGTGCAC
CTCGAGTTCGT -> TCGAGTTCGTT
CTCGATCTTAT -> TCGATCTTATA
CTCGCCGGCTG -> TCGCCGGCTGA
CTCGCCTCGAG -> TCGCCTCGAGG
CTCGGTCGGAC -> TCGGTCGGACG
CTCGTCCATCC -> TCGTCCATCCC
CTCTCCCTGAG -> TCTCCCTGAGA
CTCTTCTTGAT -> TCTTCTTGATA
CTCTTGCTTCT -> TCTTGCTTCTG
CTGAAGTCACT -> TGAAGTCACTA
CTGAAGTGATC -> TGAAGTGATCA
CTGACATCCCC -> TGACATCCCCT
CTGACTGAAGT -> TGACTGAAGTG
CTGAGAATGAT -> TGAGAATGATA
CTGAGAGCGGA -> TGAGAGCGGAC
CTGAGCCGTGT -> TGAGCCGTGTT
CTGATAGAAGC -> TGATAGAAGCT
CTGATCTCGAG -> TGATCTCGAGC
CTGCACGGCGG -> TGCACGGCGGT
CTGCACTCTTG -> TGCACTCTTGC
CTGCATTGGCG -> TGCATTGGCGA
CTGCCACGCAG -> TGCCACGCAGT
CTGCCGACGTC -> TGCCGACGTCT
CTGCCTGATAG -> TGCCTGATAGA
CTGCCTTCGGG -> TGCCTTCGGGG
CTGCCTTCGTT -> TGCCTTCGTTA
CTGCGACAGCT -> TGCGACAGCTG
CTGGAGTTCGT -> TGGAGTTCGTT
CTGGTCTGAGC -> TGGTCTGAGCC
CTGTAGAAAGA -> TGTAGAAAGAG
CTGTAGTACGA -> TGTAGTACGAC
CTGTTCAGGAG -> TGTTCAGGAGT
CTTAAGCCGGT -> TTAAGCCGGTC
CTTACAGTTGC -> TTACAGTTGCT
CTTACGCGAAA -> TTACGCGAAAA
CTTATACCATC -> TTATACCATCA
CTTATATGGTG -> TTATATGGTGC
CTTCACTCTCC -> TTCACTCTCCC
CTTCCGGGGAT -> TTCCGGGGATG
CTTCGGGGGTC -> TTCGGGGGTCT
CTTCGTTAGTC -> TTCGTTAGTCA
CTTCTGATCTC -> TTCTGATCTCG
CTTCTTGATAG -> TTCTTGATAGT
CTTGATAGTGG -> TTGATAGTGGC
CTTGCTTCTGA -> TTGCTTCTGAT
CTTGGTGGCCG -> TTGGTGGCCGT
CTTTACACATG -> TTTACACATGA
CTTTCAGCAGA -> TTTCAGCAGAG
GAAAACTCGGT -> AAAACTCGGTC
GAAACTTTACA -> AAACTTTACAC
GAAAGAGGGTT -> AAAGAGGGTTA
GAACTGTTCAG -> AACTGTTCAGG
GAAGCGGGGCA -> AAGCGGGGCAG
GAAGCTTAAGC -> AAGCTTAAGCC
GAAGTCACTAC -> AAGTCACTACG
GAAGTGATCAG -> AAGTGATCAGG
GAAGTGTGAGA -> AAGTGTGAGAC
GAATAAACCCG -> AATAAACCCGA
GAATAGTGTTC -> AATAGTGTTCC
GAATGATAGTC -> AATGATAGTCA
GAATGTCAGAC -> AATGTCAGACA
GAATTCCCCCT -> AATTCCCCCTG
GACAACGTGTA -> ACAACGTGTAA
GACAGCTGTAG -> ACAGCTGTAGT
GACATATTGAC -> ACATATTGACC
GACATCCCCTG -> ACATCCCCTGC
GACATGTATAT -> ACATGTATATA
GACATTAGGGT -> ACATTAGGGTC
GACCCAGTATA -> ACCCAGTATAT
GACCGTCACCT -> ACCGTCACCTC
GACGCAGTTTC -> ACGCAGTTTCC
GACGCCGTTGG -> ACGCCGTTGGT
GACGCGATTCA -> ACGCGATTCAC
GACGTCTGCAC -> ACGTCTGCACG
GACGTGATCAT -> ACGTGATCATT
GACTAAGTAGG -> ACTAAGTAGGG
GACTCTTCTTG -> ACTCTTCTTGA
GACTGAAGTGA -> ACTGAAGTGAT
GACTGGAGTTC -> ACTGGAGTTCG
GAGAATGATAG -> AGAATGATAGT
GAGACGCGATT -> AGACGCGATTC
GAGACTCTTCT -> AGACTCTTCTT
GAGACTGGAGT -> AGACTGGAGTT
GAGAGCGGACG -> AGAGCGGACGT
GAGCACTGACT -> AGCACTGACTG
GAGCATTCGTC -> AGCATTCGTCA
GAGCCGTGTTG -> AGCCGTGTTGG
GAGCGGACGTG -> AGCGGACGTGA
GAGGAGGTGAG -> AGGAGGTGAGC
GAGGGCATCGG -> AGGGCATCGGC
GAGGGTTATCA -> AGGGTTATCAG
GAGGTGAGCAT -> AGGTGAGCATT
GAGGTGCACCG -> AGGTGCACCGG
GAGGTTCGAGA -> AGGTTCGAGAC
GAGTAGAGGGC -> AGTAGAGGGCA
GAGTGTCCGAT -> AGTGTCCGATA
GAGTTCGTTCA -> AGTTCGTTCAA
GAGTTCGTTCC -> AGTTCGTTCCA
GAGTTCGTTCG -> AGTTCGTTCGC
GAGTTCGTTCT -> AGTTCGTTCTC
GAGTTTTTCTG -> AGTTTTTCTGG
GATAGAAGCTT -> ATAGAAGCTTA
GATAGGCTCAC -> ATAGGCTCACA
GATAGTCAGCC -> ATAGTCAGCCG
GATAGTGGCGT -> ATAGTGGCGTC
GATATTAGCGT -> ATATTAGCGTG
GATCAGGCAAA -> ATCAGGCAAAC
GATCAGTCGAG -> ATCAGTCGAGA
GATCATTATGT -> ATCATTATGTC
GATCGTAATTC -> ATCGTAATTCC
GATCTCGAGCA -> ATCTCGAGCAC
GATCTTATATG -> ATCTTATATGG
GATGATGCGGG -> ATGATGCGGGT
GATGCGGGTAG -> ATGCGGGTAGC
GATTAGTTGTT -> ATTAGTTGTTT
GATTCACTGAA -> ATTCACTGAAG
GATTGCCGTCC -> ATTGCCGTCCA
GCAAACTAACG -> CAAACTAACGG
GCAAACTGCCA -> CAAACTGCCAC
GCAAATATGAG -> CAAATATGAGT
GCAATTTCTTC -> CAATTTCTTCA
GCACAGTTATC -> CACAGTTATCC
GCACATATCGA -> CACATATCGAT
GCACCGGTCAT -> CACCGGTCATA
GCACGGCGGTC -> CACGGCGGTCT
GCACTCTTGCT -> CACTCTTGCTT
GCACTGACTGA -> CACTGACTGAA
GCAGACCCAGT -> CAGACCCAGTA
GCAGAGTAGAG -> CAGAGTAGAGG
GCAGAGTTCGT -> CAGAGTTCGTT
GCAGCGGCTCA -> CAGCGGCTCAT
GCAGTACGCGG -> CAGTACGCGGC
GCAGTTTCCTA -> CAGTTTCCTAA
GCATCATCCCC -> CATCATCCCCT
GCATCCCCTGC -> CATCCCCTGCC
GCATCGGCGGG -> CATCGGCGGGA
GCATTCGTCAA -> CATTCGTCAAG
GCATTGGCGAT -> CATTGGCGATT
GCCACGCAGTG -> CCACGCAGTGT
GCCAGCTCGAT -> CCAGCTCGATC
GCCCGGCAGTA -> CCCGGCAGTAC
GCCCTTATACC -> CCCTTATACCA
GCCGACAACGT -> CCGACAACGTG
GCCGACGTCTG -> CCGACGTCTGC
GCCGGCTGACA -> CCGGCTGACAT
GCCGGTCTTTC -> CCGGTCTTTCA
GCCGTCCACCT -> CCGTCCACCTA
GCCGTCCTATG -> CCGTCCTATGC
GCCGTCTGCAC -> CCGTCTGCACT
GCCGTGTTGGA -> CCGTGTTGGAC
GCCGTTGGTTT -> CCGTTGGTTTG
GCCTCGAGGTG -> CCTCGAGGTGC
GCCTGATAGAA -> CCTGATAGAAG
GCCTTCGGGGG -> CCTTCGGGGGT
GCCTTCGTTAG -> CCTTCGTTAGT
GCGAAAACTCG -> CGAAAACTCGG
GCGACAGCTGT -> CGACAGCTGTA
GCGATTAGTTG -> CGATTAGTTGT
GCGATTCACTG -> CGATTCACTGA
GCGCAAATATG -> CGCAAATATGA
GCGCAGCGGCT -> CGCAGCGGCTC
GCGCTCGCCTC -> CGCTCGCCTCG
GCGGACGTGAT -> CGGACGTGATC
GCGGCCCTTAT -> CGGCCCTTATA
GCGGCTCATGT -> CGGCTCATGTA
GCGGGAATAAA -> CGGGAATAAAC
GCGGGGCAGAC -> CGGGGCAGACC
GCGGGTAGCGT -> CGGGTAGCGTA
GCGGGTTACCC -> CGGGTTACCCG
GCGGTCATTCT -> CGGTCATTCTT
GCGGTCTGTAG -> CGGTCTGTAGA
GCGTACGCACA -> CGTACGCACAG
GCGTCCCAATA -> CGTCCCAATAC
GCGTGATCAGT -> CGTGATCAGTC
GCGTGTCACCG -> CGTGTCACCGC
GCTATCTTACA -> CTATCTTACAG
GCTCACAGCGT -> CTCACAGCGTG
GCTCATGTATT -> CTCATGTATTT
GCTCGATCTTA -> CTCGATCTTAT
GCTCGCCTCGA -> CTCGCCTCGAG
GCTGACATCCC -> CTGACATCCCC
GCTGAGAATGA -> CTGAGAATGAT
GCTGTAGTACG -> CTGTAGTACGA
GCTTAAGCCGG -> CTTAAGCCGGT
GCTTCCGGGGA -> CTTCCGGGGAT
GCTTCTGATCT -> CTTCTGATCTC
GGAATAAACCC -> GAATAAACCCG
GGACATGTATA -> GACATGTATAT
GGACGCAGTTT -> GACGCAGTTTC
GGACGTGATCA -> GACGTGATCAT
GGAGGTGAGCA -> GAGGTGAGCAT
GGAGTGTCCGA -> GAGTGTCCGAT
GGAGTTCGTTC -> GAGTTCGTTCG
GGATGATGCGG -> GATGATGCGGG
GGCAAACTGCC -> GCAAACTGCCA
GGCAGACCCAG -> GCAGACCCAGT
GGCAGAGTTCG -> GCAGAGTTCGT
GGCAGTACGCG -> GCAGTACGCGG
GGCATCGGCGG -> GCATCGGCGGG
GGCCCTTATAC -> GCCCTTATACC
GGCCGTCTGCA -> GCCGTCTGCAC
GGCGATTAGTT -> GCGATTAGTTG
GGCGCTCGCCT -> GCGCTCGCCTC
GGCGGGAATAA -> GCGGGAATAAA
GGCGGTCATTC -> GCGGTCATTCT
GGCGGTCTGTA -> GCGGTCTGTAG
GGCGTCCCAAT -> GCGTCCCAATA
GGCTCACAGCG -> GCTCACAGCGT
GGCTCATGTAT -> GCTCATGTATT
GGCTGACATCC -> GCTGACATCCC
GGCTTCCGGGG -> GCTTCCGGGGA
GGGAATAAACC -> GGAATAAACCC
GGGATGATGCG -> GGATGATGCGG
GGGCAGACCCA -> GGCAGACCCAG
GGGCATCGGCG -> GGCATCGGCGG
GGGCGGTCATT -> GGCGGTCATTC
GGGCTTCCGGG -> GGCTTCCGGGG
GGGGATGATGC -> GGGATGATGCG
GGGGCAGACCC -> GGGCAGACCCA
GGGGGTCTCAA -> GGGGTCTCAAG
GGGGTAGGTAG -> GGGTAGGTAGA
GGGGTCTCAAG -> GGGTCTCAAGA
GGGTAGCGTAC -> GGTAGCGTACG
GGGTAGGTAGA -> GGTAGGTAGAT
GGGTCGCGCAG -> GGTCGCGCAGC
GGGTCTCAAGA -> GGTCTCAAGAT
GGGTCTTACGC -> GGTCTTACGCG
GGGTTACCCGC -> GGTTACCCGCC
GGGTTATCAGG -> GGTTATCAGGC
GGTAGAAGTGT -> GTAGAAGTGTG
GGTAGATATTA -> GTAGATATTAG
GGTAGCGTACG -> GTAGCGTACGC
GGTAGGTAGAT -> GTAGGTAGATA
GGTCACGCAAA -> GTCACGCAAAC
GGTCATAGTAA -> GTCATAGTAAG
GGTCATTCTTG -> GTCATTCTTGG
GGTCGCGCAGC -> GTCGCGCAGCG
GGTCGGACGCA -> GTCGGACGCAG
GGTCTCAAGAT -> GTCTCAAGATT
GGTCTGAGCCG -> GTCTGAGCCGT
GGTCTGTAGAA -> GTCTGTAGAAA
GGTCTTACGCG -> GTCTTACGCGA
GGTCTTTCAGC -> GTCTTTCAGCA
GGTGAATAGTG -> GTGAATAGTGT
GGTGAGCATTC -> GTGAGCATTCG
GGTGCACCGGT -> GTGCACCGGTC
GGTGCTATCTT -> GTGCTATCTTA
GGTGGCCGTCT -> GTGGCCGTCTG
GGTTACCCGCC -> GTTACCCGCCA
GGTTATCAGGC -> GTTATCAGGCA
GGTTCGAGACT -> GTTCGAGACTC
GGTTTGCGGGT -> GTTTGCGGGTT
GTAACAACGAA -> TAACAACGAAT
GTAACCCGTAA -> TAACCCGTAAC
GTAAGTAGCCC -> TAAGTAGCCCG
GTAATTCCAGG -> TAATTCCAGGG
GTACCGCATCA -> TACCGCATCAT
GTACGACTAAG -> TACGACTAAGT
GTACGCACAGT -> TACGCACAGTT
GTACGCGGCCC -> TACGCGGCCCT
GTAGAAAGAGG -> TAGAAAGAGGG
GTAGAAGTGTG -> TAGAAGTGTGA
GTAGAGGGCAT -> TAGAGGGCATC
GTAGATATTAG -> TAGATATTAGC
GTAGCCCGGCA -> TAGCCCGGCAG
GTAGCGTACGC -> TAGCGTACGCA
GTAGGGCTTCC -> TAGGGCTTCCG
GTAGGTAGATA -> TAGGTAGATAT
GTAGTACGACT -> TAGTACGACTA
GTATATAAAGT -> TATATAAAGTG
GTATATCGTTA -> TATATCGTTAA
GTATTTGGCGC -> TATTTGGCGCT
GTCAAGCAATT -> TCAAGCAATTT
GTCAATGACAT -> TCAATGACATA
GTCACCGCGCA -> TCACCGCGCAA
GTCACCTCGAG -> TCACCTCGAGT
GTCACGCAAAC -> TCACGCAAACT
GTCACTACGAA -> TCACTACGAAG
GTCACTATAAC -> TCACTATAACG
GTCAGACATTA -> TCAGACATTAG
GTCAGCCGACA -> TCAGCCGACAA
GTCAGGGTCTT -> TCAGGGTCTTA
GTCATAGTAAG -> TCATAGTAAGT
GTCATTCTTGG -> TCATTCTTGGT
GTCCACCTAAG -> TCCACCTAAGA
GTCCATCCCCT -> TCCATCCCCTG
GTCCCAATACA -> TCCCAATACAA
GTCCGATAGGC -> TCCGATAGGCT
GTCCTATGCAT -> TCCTATGCATC
GTCGACGCCGT -> TCGACGCCGTT
GTCGAGACGCG -> TCGAGACGCGA
GTCGCGCAGCG -> TCGCGCAGCGG
GTCGGACGCAG -> TCGGACGCAGT
GTCTCAAGATT -> TCTCAAGATTG
GTCTGAGCCGT -> TCTGAGCCGTG
GTCTGCACGGC -> TCTGCACGGCG
GTCTGCACTCT -> TCTGCACTCTT
GTCTGTAGAAA -> TCTGTAGAAAG
GTCTTACGCGA -> TCTTACGCGAA
GTCTTTCAGCA -> TCTTTCAGCAG
GTGAATAGTGT -> TGAATAGTGTT
GTGAATTCCCC -> TGAATTCCCCC
GTGAGACTGGA -> TGAGACTGGAG
GTGAGCATTCG -> TGAGCATTCGT
GTGATCAGGCA -> TGATCAGGCAA
GTGATCAGTCG -> TGATCAGTCGA
GTGATCATTAT -> TGATCATTATG
GTGCACCGGTC -> TGCACCGGTCA
GTGCTATCTTA -> TGCTATCTTAC
GTGGCCGTCTG -> TGGCCGTCTGC
GTGGCGTCCCA -> TGGCGTCCCAA
GTGTAACCCGT -> TGTAACCCGTA
GTGTCACCGCG -> TGTCACCGCGC
GTGTCACTATA -> TGTCACTATAA
GTGTCCGATAG -> TGTCCGATAGG
GTGTGAGACTG -> TGTGAGACTGG
GTGTTCCTACC -> TGTTCCTACCG
GTGTTGGACAT -> TGTTGGACATG
GTTAAGAAACT -> TTAAGAAACTT
GTTACCCGCCA -> TTACCCGCCAG
GTTAGTCAGGG -> TTAGTCAGGGT
GTTATCAGGCA -> TTATCAGGCAG
GTTATCCCCAA -> TTATCCCCAAG
GTTCAATAACT -> TTCAATAACTC
GTTCAGGAGTG -> TTCAGGAGTGT
GTTCCAGTACC -> TTCCAGTACCG
GTTCCTACCGG -> TTCCTACCGGT
GTTCGAGACTC -> TTCGAGACTCT
GTTCGCCGTCC -> TTCGCCGTCCT
GTTCGTTCAAT -> TTCGTTCAATA
GTTCGTTCCAG -> TTCGTTCCAGT
GTTCGTTCGCC -> TTCGTTCGCCG
GTTCGTTCTCG -> TTCGTTCTCGC
GTTCTCGCCGG -> TTCTCGCCGGC
GTTGCTGAGAA -> TTGCTGAGAAT
GTTGGACATGT -> TTGGACATGTA
GTTGGTTTGCG -> TTGGTTTGCGG
GTTGTTTCGTC -> TTGTTTCGTCA
GTTTCCTAATC -> TTTCCTAATCA
GTTTCGTCAAT -> TTTCGTCAATG
GTTTGCGGGTT -> TTTGCGGGTTA
GTTTTTCTGGT -> TTTTTCTGGTC
TAAACCCGAGG -> AAACCCGAGGT
TAAAGTGAATT -> AAAGTGAATTC
TAACAACGAAT -> AACAACGAATG
TAACCCGTAAC -> AACCCGTAACA
TAACGAACTGT -> AACGAACTGTT
TAACGGGGTAG -> AACGGGGTAGG
TAACTCGTCCA -> AACTCGTCCAT
TAAGAAACTTT -> AAGAAACTTTA
TAAGAGGAGGT -> AAGAGGAGGTG
TAAGCCGGTCT -> AAGCCGGTCTT
TAAGTAGCCCG -> AAGTAGCCCGG
TAAGTAGGGCT -> AAGTAGGGCTT
TAATCAAGGTG -> AATCAAGGTGA
TAATTCCAGGG -> AATTCCAGGGC
TACAAGGTCAC -> ACAAGGTCACG
TACACATGAGT -> ACACATGAGTT
TACAGTTGCTG -> ACAGTTGCTGA
TACCATCACAC -> ACCATCACACT
TACCCGCCAGC -> ACCCGCCAGCT
TACCGCATCAT -> ACCGCATCATC
TACCGGTAGAA -> ACCGGTAGAAG
TACGAAGCGGG -> ACGAAGCGGGG
TACGACTAAGT -> ACGACTAAGTA
TACGCACAGTT -> ACGCACAGTTA
TACGCGAAAAC -> ACGCGAAAACT
TACGCGGCCCT -> ACGCGGCCCTT
TAGAAAGAGGG -> AGAAAGAGGGT
TAGAAGCTTAA -> AGAAGCTTAAG
TAGAAGTGTGA -> AGAAGTGTGAG
TAGAGGGCATC -> AGAGGGCATCG
TAGATATTAGC -> AGATATTAGCG
TAGCCCGGCAG -> AGCCCGGCAGT
TAGCGTACGCA -> AGCGTACGCAC
TAGCGTGTCAC -> AGCGTGTCACC
TAGGCTCACAG -> AGGCTCACAGC
TAGGGCTTCCG -> AGGGCTTCCGG
TAGGGTCGCGC -> AGGGTCGCGCA
TAGGTAGATAT -> AGGTAGATATT
TAGTAAGTAGC -> AGTAAGTAGCC
TAGTACGACTA -> AGTACGACTAA
TAGTCAGCCGA -> AGTCAGCCGAC
TAGTCAGGGTC -> AGTCAGGGTCT
TAGTGGCGTCC -> AGTGGCGTCCC
TAGTGTTCCTA -> AGTGTTCCTAC
TAGTTGTTTCG -> AGTTGTTTCGT
TATAAAGTGAA -> ATAAAGTGAAT
TATAACGAACT -> ATAACGAACTG
TATACCATCAC -> ATACCATCACA
TATATAAAGTG -> ATATAAAGTGA
TATATCGTTAA -> ATATCGTTAAG
TATATGGTGCT -> ATATGGTGCTA
TATCAGGCAGA -> ATCAGGCAGAG
TATCCCCAAGC -> ATCCCCAAGCA
TATCGATCGTA -> ATCGATCGTAA
TATCGTTAAGA -> ATCGTTAAGAA
TATCTTACAGT -> ATCTTACAGTT
TATGAGTTCGT -> ATGAGTTCGTT
TATGCATCCCC -> ATGCATCCCCT
TATGGTGCTAT -> ATGGTGCTATC
TATGTCGACGC -> ATGTCGACGCC
TATTAGCGTGT -> ATTAGCGTGTC
TATTGACCGTC -> ATTGACCGTCA
TATTTGGCGCT -> ATTTGGCGCTC
TCAAGATTGCC -> CAAGATTGCCG
TCAAGCAATTT -> CAAGCAATTTC
TCAAGGTGAAT -> CAAGGTGAATA
TCAATAACTCG -> CAATAACTCGT
TCAATGACATA -> CAATGACATAT
TCACACTGCGA -> CACACTGCGAC
TCACAGCGTGA -> CACAGCGTGAT
TCACCGCGCAA -> CACCGCGCAAA
TCACCTCGAGT -> CACCTCGAGTT
TCACGCAAACT -> CACGCAAACTA
TCACTACGAAG -> CACTACGAAGC
TCACTATAACG -> CACTATAACGA
TCACTCTCCCT -> CACTCTCCCTG
TCACTGAAGTC -> CACTGAAGTCA
TCAGACATTAG -> CAGACATTAGG
TCAGCAGAGTA -> CAGCAGAGTAG
TCAGCCGACAA -> CAGCCGACAAC
TCAGGAGTGTC -> CAGGAGTGTCC
TCAGGCAAACT -> CAGGCAAACTG
TCAGGCAGAGT -> CAGGCAGAGTT
TCAGGGTCTTA -> CAGGGTCTTAC
TCAGTCGAGAC -> CAGTCGAGACG
TCATAGTAAGT -> CATAGTAAGTA
TCATCCCCTGC -> CATCCCCTGCC
TCATGTATTTG -> CATGTATTTGG
TCATTATGTCG -> CATTATGTCGA
TCATTCTTGGT -> CATTCTTGGTG
TCCACCTAAGA -> CCACCTAAGAG
TCCAGGGCGGT -> CCAGGGCGGTC
TCCAGTACCGC -> CCAGTACCGCA
TCCATCCCCTG -> CCATCCCCTGC
TCCCAATACAA -> CCCAATACAAG
TCCCCAAGCAC -> CCCCAAGCACA
TCCCCCTGCAT -> CCCCCTGCATT
TCCCCTGCCGA -> CCCCTGCCGAC
TCCCCTGCCTG -> CCCCTGCCTGA
TCCCCTGCCTT -> CCCCTGCCTTC,CCCCTGCCTTC
TCCCTGAGAGC -> CCCTGAGAGCG
TCCGATAGGCT -> CCGATAGGCTC
TCCGGGGATGA -> CCGGGGATGAT
TCCTAATCAAG -> CCTAATCAAGG
TCCTACCGGTA -> CCTACCGGTAG
TCCTATGCATC -> CCTATGCATCC
TCGACGCCGTT -> CGACGCCGTTG
TCGAGACGCGA -> CGAGACGCGAT
TCGAGACTCTT -> CGAGACTCTTC
TCGAGCACTGA -> CGAGCACTGAC
TCGAGGTGCAC -> CGAGGTGCACC
TCGAGTTCGTT -> CGAGTTCGTTC
TCGATCGTAAT -> CGATCGTAATT
TCGATCTTATA -> CGATCTTATAT
TCGCCGGCTGA -> CGCCGGCTGAC
TCGCCGTCCTA -> CGCCGTCCTAT
TCGCCTCGAGG -> CGCCTCGAGGT
TCGCGCAGCGG -> CGCGCAGCGGC
TCGGACGCAGT -> CGGACGCAGTT
TCGGCGGGAAT -> CGGCGGGAATA
TCGGGGGTCTC -> CGGGGGTCTCA
TCGGTCGGACG -> CGGTCGGACGC
TCGTAATTCCA -> CGTAATTCCAG
TCGTCAAGCAA -> CGTCAAGCAAT
TCGTCAATGAC -> CGTCAATGACA
TCGTCCATCCC -> CGTCCATCCCC
TCGTGTCACTA -> CGTGTCACTAT
TCGTTAAGAAA -> CGTTAAGAAAC
TCGTTAGTCAG -> CGTTAGTCAGG
TCGTTCAATAA -> CGTTCAATAAC
TCGTTCCAGTA -> CGTTCCAGTAC
TCGTTCGCCGT -> CGTTCGCCGTC
TCGTTCTCGCC -> CGTTCTCGCCG
TCTCAAGATTG -> CTCAAGATTGC
TCTCCCTGAGA -> CTCCCTGAGAG
TCTCGAGCACT -> CTCGAGCACTG
TCTCGCCGGCT -> CTCGCCGGCTG
TCTGAGCCGTG -> CTGAGCCGTGT
TCTGATCTCGA -> CTGATCTCGAG
TCTGCACGGCG -> CTGCACGGCGG
TCTGCACTCTT -> CTGCACTCTTG
TCTGGTCTGAG -> CTGGTCTGAGC
TCTGTAGAAAG -> CTGTAGAAAGA
TCTTACAGTTG -> CTTACAGTTGC
TCTTACGCGAA -> CTTACGCGAAA
TCTTATATGGT -> CTTATATGGTG
TCTTCACTCTC -> CTTCACTCTCC
TCTTCTTGATA -> CTTCTTGATAG
TCTTGATAGTG -> CTTGATAGTGG
TCTTGCTTCTG -> CTTGCTTCTGA
TCTTGGTGGCC -> CTTGGTGGCCG
TCTTTCAGCAG -> CTTTCAGCAGA
TGAAGTCACTA -> GAAGTCACTAC
TGAAGTGATCA -> GAAGTGATCAG
TGAATAGTGTT -> GAATAGTGTTC
TGAATTCCCCC -> GAATTCCCCCT
TGACATATTGA -> GACATATTGAC
TGACATCCCCT -> GACATCCCCTG
TGACCGTCACC -> GACCGTCACCT
TGACTGAAGTG -> GACTGAAGTGA
TGAGAATGATA -> GAGAATGATAG
TGAGACTGGAG -> GAGACTGGAGT
TGAGAGCGGAC -> GAGAGCGGACG
TGAGCATTCGT -> GAGCATTCGTC
TGAGCCGTGTT -> GAGCCGTGTTG
TGAGTTCGTTC -> GAGTTCGTTCT
TGAGTTTTTCT -> GAGTTTTTCTG
TGATAGAAGCT -> GATAGAAGCTT
TGATAGTCAGC -> GATAGTCAGCC
TGATAGTGGCG -> GATAGTGGCGT
TGATCAGGCAA -> GATCAGGCAAA
TGATCAGTCGA -> GATCAGTCGAG
TGATCATTATG -> GATCATTATGT
TGATCTCGAGC -> GATCTCGAGCA
TGATGCGGGTA -> GATGCGGGTAG
TGCACCGGTCA -> GCACCGGTCAT
TGCACGGCGGT -> GCACGGCGGTC
TGCACTCTTGC -> GCACTCTTGCT
TGCATCCCCTG -> GCATCCCCTGC
TGCATTGGCGA -> GCATTGGCGAT
TGCCACGCAGT -> GCCACGCAGTG
TGCCGACGTCT -> GCCGACGTCTG
TGCCGTCCACC -> GCCGTCCACCT
TGCCTGATAGA -> GCCTGATAGAA
TGCCTTCGGGG -> GCCTTCGGGGG
TGCCTTCGTTA -> GCCTTCGTTAG
TGCGACAGCTG -> GCGACAGCTGT
TGCGGGTAGCG -> GCGGGTAGCGT
TGCGGGTTACC -> GCGGGTTACCC
TGCTATCTTAC -> GCTATCTTACA
TGCTGAGAATG -> GCTGAGAATGA
TGCTTCTGATC -> GCTTCTGATCT
TGGACATGTAT -> GGACATGTATA
TGGAGTTCGTT -> GGAGTTCGTTC
TGGCCGTCTGC -> GGCCGTCTGCA
TGGCGATTAGT -> GGCGATTAGTT
TGGCGCTCGCC -> GGCGCTCGCCT
TGGCGTCCCAA -> GGCGTCCCAAT
TGGTCTGAGCC -> GGTCTGAGCCG
TGGTGCTATCT -> GGTGCTATCTT
TGGTGGCCGTC -> GGTGGCCGTCT
TGGTTTGCGGG -> GGTTTGCGGGT
TGTAACCCGTA -> GTAACCCGTAA
TGTAGAAAGAG -> GTAGAAAGAGG
TGTAGTACGAC -> GTAGTACGACT
TGTATATAAAG -> GTATATAAAGT
TGTATTTGGCG -> GTATTTGGCGC
TGTCACCGCGC -> GTCACCGCGCA
TGTCACTATAA -> GTCACTATAAC
TGTCAGACATT -> GTCAGACATTA
TGTCCGATAGG -> GTCCGATAGGC
TGTCGACGCCG -> GTCGACGCCGT
TGTGAGACTGG -> GTGAGACTGGA
TGTTCAGGAGT -> GTTCAGGAGTG
TGTTCCTACCG -> GTTCCTACCGG
TGTTGGACATG -> GTTGGACATGT
TGTTTCGTCAA -> GTTTCGTCAAT
TTAAGAAACTT -> TAAGAAACTTT
TTAAGCCGGTC -> TAAGCCGGTCT
TTACACATGAG -> TACACATGAGT
TTACAGTTGCT -> TACAGTTGCTG
TTACCCGCCAG -> TACCCGCCAGC
TTACGCGAAAA -> TACGCGAAAAC
TTAGCGTGTCA -> TAGCGTGTCAC
TTAGGGTCGCG -> TAGGGTCGCGC
TTAGTCAGGGT -> TAGTCAGGGTC
TTAGTTGTTTC -> TAGTTGTTTCG
TTATACCATCA -> TATACCATCAC
TTATATGGTGC -> TATATGGTGCT
TTATCAGGCAG -> TATCAGGCAGA
TTATCCCCAAG -> TATCCCCAAGC
TTATGTCGACG -> TATGTCGACGC
TTCAATAACTC -> TCAATAACTCG
TTCACTCTCCC -> TCACTCTCCCT
TTCACTGAAGT -> TCACTGAAGTC
TTCAGCAGAGT -> TCAGCAGAGTA
TTCAGGAGTGT -> TCAGGAGTGTC
TTCCAGGGCGG -> TCCAGGGCGGT
TTCCAGTACCG -> TCCAGTACCGC
TTCCCCCTGCA -> TCCCCCTGCAT
TTCCGGGGATG -> TCCGGGGATGA
TTCCTAATCAA -> TCCTAATCAAG
TTCCTACCGGT -> TCCTACCGGTA
TTCGAGACTCT -> TCGAGACTCTT
TTCGCCGTCCT -> TCGCCGTCCTA
TTCGGGGGTCT -> TCGGGGGTCTC
TTCGTCAAGCA -> TCGTCAAGCAA
TTCGTCAATGA -> TCGTCAATGAC
TTCGTTAGTCA -> TCGTTAGTCAG
TTCGTTCAATA -> TCGTTCAATAA
TTCGTTCCAGT -> TCGTTCCAGTA
TTCGTTCGCCG -> TCGTTCGCCGT
TTCGTTCTCGC -> TCGTTCTCGCC
TTCTCGCCGGC -> TCTCGCCGGCT
TTCTGATCTCG -> TCTGATCTCGA
TTCTGGTCTGA -> TCTGGTCTGAG
TTCTTCACTCT -> TCTTCACTCTC
TTCTTGATAGT -> TCTTGATAGTG
TTCTTGGTGGC -> TCTTGGTGGCC
TTGACCGTCAC -> TGACCGTCACC
TTGATAGTGGC -> TGATAGTGGCG
TTGCCGTCCAC -> TGCCGTCCACC
TTGCGGGTTAC -> TGCGGGTTACC
TTGCTGAGAAT -> TGCTGAGAATG
TTGCTTCTGAT -> TGCTTCTGATC
TTGGACATGTA -> TGGACATGTAT
TTGGCGATTAG -> TGGCGATTAGT
TTGGCGCTCGC -> TGGCGCTCGCC
TTGGTGGCCGT -> TGGTGGCCGTC
TTGGTTTGCGG -> TGGTTTGCGGG
TTGTTTCGTCA -> TGTTTCGTCAA
TTTACACATGA -> TTACACATGAG
TTTCAGCAGAG -> TTCAGCAGAGT
TTTCCTAATCA -> TTCCTAATCAA
TTTCGTCAATG -> TTCGTCAATGA
TTTCTGGTCTG -> TTCTGGTCTGA
TTTCTTCACTC -> TTCTTCACTCT
TTTGCGGGTTA -> TTGCGGGTTAC
TTTGGCGCTCG -> TTGGCGCTCGC
TTTTCTGGTCT -> TTTCTGGTCTG
TTTTTCTGGTC -> TTTTCTGGTCT